[    ][ B1 ][ C1 ][ D1 ][    ][    ][    ]
[ A2 ][ B2 ][    ][ D2 ][    ][    ][ G2 ]
[    ][ B3 ][ C3 ][ D3 ][ E3 ][ F3 ][ G3 ]
[    ][ B4 ][ C4 ][    ][ E4 ][    ][    ]
[    ][    ][    ][    ][ E5 ][ F5 ][ G5 ]